111111111111111111
100000000000000001
100000090000000001
100000000000000001
100007003073000001
180003000000007001
133300000000003001
100000000000000001
100000000500000021
100000002220000211
100022221116662111
122211111114441111