111111111111111111
100000000000000000
100000000000000008
100000090000000022
100000050003307001
100000333000430001
170033000000000001
100000000007000021
100000000030302211
100000222000001111
100002111666661111
122221111444441111
