111111111111111111
100000000000000001
100000000000000001
100000000007000001
100000000000000091
100000000000000031
100000000000003001
100000000000000071
100000007003000001
100000005000000001
100022222230000081
122211111146666641