111111111111111111
100000000000000001
100000000000000001
180000000000000001
130030030033000001
100000000000070001
170000000000003001
103000000030000001
100000030000090031
100030000007000001
100000000000003001
133666666663666661